101010010101
NO4444444444
101000010101
100000000001
S0
100000000001
111111111111
WE
EA
F
C