

NO ./textures/wall_no.png
 SO                  ./textures/wall_so.png
EA ./textures/wall_ea.png
WE                  ./textures/wall_we.png
F 254     ,45,60
C 225,30,5



              1                                     
             101  
            10001                                               
           1000001
          100000001
          110001111                  
         10000N0001111  
          111111111  1                 
           1     1    1    1
            1 0 1111111
             1 1      1
              1
