11111111111111
11111111111111
11111111111111
NO11111111111
1SO11111111111
