111111111
NO1111111111111
EA111111
WE11111111111111
F1111111111111111
SO111111
C111111111111111