NO                  ./textures/wall_no.png




SO                  /telecharger les autres textures 







WE    /telecharger les autres textures 
EA /telecharger les autres textures 
F /telecharger les autres textures 
C /telecharger les autres textures 


4444444444
111111111111111

00000000

p
