

NO ./textures/wall_no.png
 SO                  ./textures/wall_so.png
EA ./textures/wall_ea.png
WE                  ./textures/wall_we.png
F 254     ,45,60
C 225,30,5



111111111
111111  1
110001111
10011
100001111
10000001
1000S001
11111111
1
111111111
