11111111111111
11111111111111
11111111111111
1P11111111111
1111111111111
