
NO                                                             ./textures/wall_no.png



SO                  ./textures/wall_so.png
EA ./textures/wall_ea.png
WE                  ./textures/wall_we.png
F 254,45,60
C 225,30,5


111111111
111111111
1111111
110 1E11
   111111111
